################################################
#           #            #                     #
######      #######  ##########     #######    #
#                    #        #         #      #
#           #        #    #   ########  #   ####
# ###########        #    #        #    #      #
#      #    #######  #             #    #      #
#      #          #  #########  ####   #########
#                 #                    #       #
###############   ######## #############       #
#                 #      #       #             #
#   ###########   #      ######       #  #######
#      #                      #       #        #
#      #    ##############    ###############  #
#      #                 #            #        #
################################################